pathway	type
B1	vitamin
B2	vitamin
B3	vitamin
B5	vitamin
B6	vitamin
B7	vitamin
B9	vitamin
B12	vitamin
Arg	amino_acid
Lys	amino_acid
His	amino_acid
Trp	amino_acid
Tyr	amino_acid
Phe	amino_acid
Chor	amino_acid
Ile	amino_acid
Val	amino_acid
Leu	amino_acid
Ser	amino_acid
Cys	amino_acid
Thr	amino_acid
Met	amino_acid
Pro	amino_acid
Gly	amino_acid
Glu	amino_acid
Gln	amino_acid
Asp	amino_acid
Asn	amino_acid
Urea_d	other
